TILEMAP
25 15							-- Size of tile map in tiles
32 32							-- Tile size & block size
12 6 11 0 2 0 0 0 0 0 0 0 14 0 0 0 0 0 0 0 0 0 0 0 0 
0 0 0 0 2 0 0 0 0 0 3 3 14 3 3 3 3 3 3 3 0 0 0 0 0 
15 6 16 0 2 0 0 0 0 0 3 0 14 0 0 3 0 0 0 3 0 0 0 0 0 
0 0 0 0 2 0 0 0 0 0 3 0 14 0 0 0 0 0 0 3 0 0 0 0 0 
8 6 9 0 2 0 0 0 0 0 3 0 14 0 0 0 0 4 0 3 0 0 0 0 0 
0 0 0 0 2 0 3 3 3 3 3 0 14 0 0 3 0 0 0 3 0 0 0 0 0 
2 2 2 2 2 0 3 0 0 0 3 0 14 0 0 3 3 3 3 3 0 0 0 0 0 
0 0 0 0 0 0 3 0 1 0 0 0 14 3 3 3 0 0 0 0 0 0 0 0 0 
0 0 0 0 0 0 3 0 0 0 3 0 14 14 14 14 14 14 14 14 14 14 14 14 14 
0 0 0 0 0 0 3 3 3 3 3 0 0 0 0 3 0 0 0 0 0 0 0 0 0 
0 0 0 0 5 0 0 0 0 0 3 0 10 6 11 3 0 0 0 0 0 0 0 0 0 
0 0 0 0 6 0 0 0 0 0 3 0 0 0 0 3 0 0 0 0 0 0 0 0 0 
0 0 0 0 7 0 0 0 0 0 3 3 3 3 3 3 0 0 0 0 0 0 0 0 0 
0 0 0 0 0 0 0 0 0 0 0 0 0 0 0 0 0 0 0 0 0 0 0 0 0 
0 0 0 0 0 0 0 0 0 0 0 0 0 0 0 0 0 0 0 0 0 0 0 0 0

