TILEMAP
100 8							-- Size of tile map in tiles
32 32							-- Tile size & block size
0 0 0 0 0 0 0 0 0 0 0 0 21 21 0 0 0 0 0 0 0 0 0 0 0 0 0 0 0 0 0 0 0 0 0 0 14 0 14 0 0 0 0 0 0 0 0 0 0 3 3 0 0 0 0 0 14 0 0 14 0 0 0 0 0 0 0 12 4 0 0 0 0 0 0 0 0 14 0 0 0 0 0 0 4 4 0 0 0 0 0 0 0 0 0 0 0 0 0 0 
0 0 0 0 0 0 0 0 0 0 0 0 21 21 0 0 0 0 0 0 0 0 0 0 0 0 0 0 0 0 0 0 14 0 0 0 14 0 0 0 0 0 0 0 0 0 0 0 0 3 3 0 0 0 0 14 0 0 0 0 0 0 0 0 0 0 0 6 4 0 0 0 0 0 0 0 0 0 0 14 0 10 0 0 4 4 4 0 0 0 0 0 0 0 0 0 0 0 0 0 
0 0 0 0 0 0 0 0 0 0 0 0 21 21 0 0 0 0 0 0 0 0 0 0 0 0 0 0 0 0 0 0 14 0 14 0 14 0 0 0 14 0 0 0 0 0 0 0 0 3 3 0 0 14 0 14 0 0 17 14 0 0 0 0 0 0 0 13 4 0 2 0 2 0 0 0 0 0 14 0 0 0 0 0 4 4 4 4 0 0 0 0 0 0 0 0 0 0 0 0 
0 0 0 0 0 0 0 0 0 0 0 0 21 21 0 0 0 0 0 0 0 0 0 0 0 0 0 0 0 0 0 14 0 0 0 0 0 14 0 14 0 0 0 0 0 0 0 0 0 3 3 0 0 0 0 14 0 0 0 14 14 0 0 0 0 0 0 0 4 0 0 0 0 0 0 0 0 0 0 0 14 0 0 0 4 4 4 4 4 3 0 0 0 0 0 0 0 0 0 0 
0 0 0 0 0 0 0 0 0 0 0 0 21 21 0 0 0 0 0 0 0 0 0 0 0 0 0 1 0 0 0 0 14 0 0 0 0 14 0 0 0 0 0 0 0 0 0 0 0 3 3 0 0 0 0 14 0 0 14 14 0 0 0 0 0 7 0 0 4 0 0 2 0 0 2 0 0 14 0 5 0 0 0 0 4 4 4 4 4 0 0 0 0 0 0 0 0 0 0 0 
0 0 0 0 0 0 0 0 0 0 0 0 21 21 0 0 0 0 0 0 0 0 0 0 0 0 0 0 0 0 0 0 14 0 0 0 0 14 0 0 14 0 0 0 0 0 0 0 13 3 3 0 0 0 0 0 0 14 0 14 0 0 0 0 0 0 0 0 4 0 0 2 0 2 0 0 0 0 0 14 0 0 6 0 4 4 4 4 0 8 6 9 17 11 0 0 0 0 0 0 
0 0 0 0 0 0 0 0 0 0 0 0 21 21 0 0 0 0 0 0 0 0 0 0 0 0 0 0 0 0 0 14 0 0 14 0 0 0 0 0 0 0 14 0 0 0 0 6 0 3 3 0 0 0 0 0 0 14 0 0 0 0 0 0 0 0 0 0 4 0 2 0 0 0 0 0 0 0 14 0 0 0 0 0 4 4 4 0 0 0 0 0 0 0 0 0 0 15 6 16 
0 0 0 0 0 0 0 0 0 0 0 0 21 21 0 0 0 0 0 0 0 0 0 0 0 0 0 0 0 0 14 14 0 0 0 14 0 0 0 0 0 0 0 0 0 0 10 0 0 3 3 10 6 11 0 0 14 0 0 0 0 14 0 0 0 0 0 0 4 0 0 2 0 0 0 0 14 0 0 14 0 0 0 0 4 4 0 0 0 0 0 0 0 0 0 0 0 5 6 7
