TILEMAP
20 15							-- Size of tile map in tiles
32 32							-- Tile size & block size
2 2 2 2 2 2 2 0 14 0 0 0 0 0 3 3 0 12 6 11 
2 10 17 15 6 16 2 0 14 0 0 0 9 3 0 0 0 0 0 0 
0 0 0 0 0 0 0 0 14 0 0 0 0 0 3 3 0 8 6 11 
0 0 0 0 0 0 0 2 2 2 2 2 0 0 0 0 0 0 0 0 
0 0 0 0 0 0 0 2 0 0 0 2 3 3 3 3 3 0 0 0 
0 0 14 14 14 0 0 2 4 0 0 2 0 0 0 0 0 3 0 3 
0 0 0 14 14 0 0 2 2 3 2 2 0 0 0 0 0 0 3 0 
0 0 0 14 14 0 0 2 1 0 2 2 0 0 0 14 0 0 0 0 
0 0 0 14 14 0 0 0 2 6 2 0 0 0 0 14 0 0 0 0 
0 0 0 14 14 0 0 0 0 0 0 0 0 0 0 14 0 0 0 0 
0 0 0 14 14 0 0 0 0 0 0 0 0 0 0 14 0 0 0 0 
14 0 13 0 14 14 14 14 0 0 0 0 14 14 14 14 0 0 0 0 
14 0 17 0 0 0 0 14 0 0 0 0 14 0 0 0 0 0 0 0 
14 0 14 0 0 0 0 14 0 0 0 0 14 0 0 0 0 0 0 0 
14 0 14 0 0 0 0 14 0 0 0 0 14 0 0 0 0 5 6 7

